111111111111111
10000000000000111111
10000100000000000001
10000000001111111111
10000000001
10000000001
10000001001
11111111111