NO ./resources/brickwall009b.xpm
SO ./resources/brickwall010g.xpm
WE ./resources/brickwall010b.xpm
EA ./resources/brickwall010c.xpm

F 128,128,128
C 102,178,255

        1111111111111111111111111
        1000000000110000000000001
        1011000001110000000000001
        1001000000000000000000001
111111111011000001110000000000001
100000000011000001110111111111111
11110111111111011100000010001
11110111111111011101010010001
11000010100101011100000010001
10001000010100001100000010001
100000S0010000001101010010001
1101001111010101111101111000111
11110111 1110101 101111010001
11111111 1111111 111111111111