NO ./resources/plasterwall002a.xpm
SO ./resources/plasterwall002c.xpm
WE ./resources/plasterwall002e.xpm
EA ./resources/plasterwall002g.xpm

F 2,219,17
C 66,102,245

111111111111111111111111
1E0000000000000000000001
1D1D1D1D1D1D1D1D1D1D1D11
101010101010101010101011
101010101010101010101011
101010101010101010101011
101010101010101010101011
111111111011111111111111
        101
        101
        101
        101
        1B1
        111